XXXXXXXXXXXXXXX
X    X        X
X X  X XXXXX  X
X X    X   X  X
X         XX  X
XSX    X     EX
XXXXXXXXXXXXXXX