XXXXXXXXXXXXXXX
X    X        X
X X  X XXXXX  X
X X    X   X  X
X         XX  X
XoX    X
XXXXXXXXXXXXXXX